num,Monster,noteLength,noteNums0,noteNums1,noteNums2,noteNums3
8,,,,,,
0,Rose,4,2,1,1,0
0,Rose,4,0,3,0,0
0,Rose,4,2,2,2,1
0,Rose,4,1,2,2,3
0,Rose,4,0,0,3,3
0,Rose,4,3,3,2,1
0,Rose,4,2,3,1,1
0,Rose,4,0,1,1,0
