num,num2,Monster,noteLength,noteNums0,noteNums1,noteNums2,noteNums3
8,,,,,,,
0,0,Rose,4,3,2,2,1
0,0,Rose,4,1,4,1,1
0,0,Rose,4,3,3,3,2
0,0,Rose,4,2,3,3,4
0,0,Rose,4,1,1,4,4
0,0,Rose,4,4,4,3,2
0,0,Rose,4,3,4,2,2
0,0,Rose,4,1,2,2,1
